11111111111111122222222222222222222222222222222222222222222222222
10000010000000122222222222222222222222222222222222222222222222222    
10000111111111111111111112222222222222222222222222222222222222222
100N0110000000000000100012222222222222222222222222222222222222222
10000100000000000000000012222222222222222222222222222222222222222
10000011000000000000010001222222222222222222222222222222222222222
11101111111011111111110001222222222222222222222222222222222222222
110000110000001      10001222222222222222222222222222222222222222
100000010000001      10001222222222222222222222222222222222222222
100000010000001      10001222222222222222222222222222222222222222
10000000000000111111111011111111111222222222222222222222222222222
10000001000000100000000000000000001222222222222222222222222222222
10000001000000100000000000000000001111122222222222222222222222222
11000011000000100111000000000011001000122222222222222222222222222
11111111111111100100000000000001001000122222222222222222222222222
              100000000000000000001000122222222222222222222222222
              100000000000000000001000122222222222222222222222222
              100000000000000000000000122222222222222222222222222
              100000000000000000001000122222222222222222222222222
              100000000000000000001000122222222222222222222222222
              100100000000000001001000122222222222222222222222222
              100110000000000011001000122222222222222222222222222
              100000000000000000001000122222222222222222222222222
              100000000000000000001000122222222222222222222222222
              111111111111111111111000122222222222222222222222222
                                  1000122222222222222222222222222
                               1111000111122222222222222222222222
                               1000000000122222222222222222222222
   1111111111111               1000000000122222222222222222222222
   1000000000001               1000000000122222222222222222222222
   1000000000001               1000000000122222222222222222222222
   1000000000001               1000000000122222222222222222222222
   1000000000001               1010000010122222222222222222222222
   1000000000001               1000000000122222222222222222222222
   10011111111111111111111     1111101111122222222222222222222222
   10000000000000000000001       10000122222222222222222222222222
   11110000000000000000001       10000122222222222222222222222222
      10000000000000000001       10000122222222222222222222222222
  111110000000000001110111111111110000122222222222222222222222222
  100000000000000001000000000000000000122222222222222222222222222
  100010000000000001000000000000000000122222222222222222222222222
  100010000000000001000000000000000000122222222222222222222222222
  100011111101111111000000000000000000122222222222222222222222222
  1000000010001    1110111111111111111122222222222222222222222222
  1000000000001    1000000000012222222222222222222222222222222222
  1000000010001    1000000000012222222222222222222222222222222222
  1111011110001    1000000000012222222222222222222222222222222222
    10001 10101    1000000000012222222222222222222222222222222222
    10001110111    1000000000012222222222222222222222222222222222
    10000000001    1000000000012222222222222222222222222222222222
    11111100001    1111110111112222222222222222222222222222222222
         110001        100012222222222222222222222222222222222222
          10001        100012222222222222222222222222222222222222
           10001       101012222222222222222222222222222222222222
            10001      111112222222222222222222222222222222222222
             1000122222222222222222222222222222222222222222222222
              100012222222222222222222222222222222222222222222222
               10001222222222222222222222222222222222222222222222
                1000111111111111111111111111111111111111122222222
                1000001000100000100000001000000000101000122222222
                1110101010101110101110111011101110101110122222222
                1000100010101010100010000010101000000000122222222
                1010111011111010111111101010111011111111122222222
                1010101010000000001000001010001010001000122222222
                1011101111111111101011111010111111101010122222222
                1010101000100000101000001000001010000010122222222
                1010101010111011101110101111111011111110122222222
                1000001010100000100000101010001000100000122222222
                1010101011111110111011111010111110101110122222222
                1010100000001000001000000000001000000010122222222
                1110101011111011101010101110111011111111122222222
                1010101000000010000010100010000010000000122222222
                1010111011101011101010111111111010111110122222222
                1000100000101000101010100000001000001010122222222
                1011101110111010101111101110111011101010122222222
                1010001000101010100000100010001000101010122222222
                1011101010101110111110101110111110101010122222222
                1010001010100010100010000010001010101000122222222
                1011101010111010111010101111111011101110122222222
                1010101010000010100000100010001000101010122222222
                1010111010111111111010111110111010101010122222222
                1000100010001000000010001000001010101010122222222
                1010101110101010111111111011111011101011122222222
                1010101000101010000000000010000010001000122222222
                1010101111101111111111111010111111111110122222222
                1010100010100000100000100010100000100000122222222
                1110111010111111101011111010101011101111122222222
                1000100000001000001010001000001010000000122222222
                1011111111101110101010111111111011111110122222222
                1010000000100000101000001000001000101000122222222
                1110101011111011101111101011111110101010122222222
                1000101010000010000000101010000010001010122222222
                1010111010101110111110111010111011101011122222222
                1010100010101000001000001000100000001000122222222
                1010101110101011101111111111101011101010122222222
                1010100000101010100000000000101000100010122222222
                1010111111101010101110111110101110111110111111111
                1010000010001000101000000010101000000010000000001
                1111111111111111111111111111111111111111100000001
                                                        100000001
                                                        100000001
                                                        100000001
                                                        100000001
                                                        111111111
1