NO        textures/HITLER.png


WE       textures/brick.png





EA          textures/eagle.png





SO              textures/hitlerflag.png


F            0,1,1

C    245,245,245



1111111111111111
1000000000000001
1000000000000001
1000000000000001
1000000000000001
1000000000000001
1000000000000001
1000000000000001
1000000000000001
1000000000000001
1000000000000001
1000000S00000001
1000000000000001
1000000000000001
1000000000000001
1000000000000001
1000000000000001
1000000000000001
1000000000000001
1111111111111111