NO textures/HITLER.png


WE      textures/brick.png


EA textures/eagle.png


SO textures/hitlerflag.png


C    245,245,245

F 0,1,0

        11111111111 11111111111111
        1000000000110000000000001
        1011000001110000000000001
        1001000000000000000000001
111111111011000001110000000000001
100000000011000001110111111111111
11110111111111011100000010001
11110111111111011101010010001
11000000110101011100000010001
1000000000000001100000010001
100N0000000000001101010010001
11000001110101011111001110001
11110111 1110101 1011011010001
11111111 1111111 111111111111